[
	{
		"level": "Solo",
		"grid": [
			" ################### ",
			" #........#........# ",
			" #o##.###.#.###.##o# ",
			" #.................# ",
			" #.##.#.#####.#.##.# ",
			" #....#...#...#....# ",
			" ####.### # ###.#### ",
			"    #.#       #.#    ",
			"#####.# ##=## #.#####",
			"     .  #   #  .     ",
			"#####.# ##### #.#####",
			"    #.#       #.#    ",
			" ####.# ##### #.#### ",
			" #........#........# ",
			" #.##.###.#.###.##.# ",
			" #o.#..... .....#.o# ",
			" ##.#.#.#####.#.#.## ",
			" #....#...#...#....# ",
			" #.######.#.######.# ",
			" #.................# ",
			" ################### "
		]
	},
	{
		"level": "Versus",
		"grid": [
			" ################### ",
			" #........#........# ",
			" #o##.###.#.###.##o# ",
			" #.................# ",
			" #.##.#.#####.#.##.# ",
			" #....#.......#....# ",
			"#####.#.#####.#.#####",
			"     .#       #.     ",
			"#####.# ##=## #.#####",
			"     .# #   # #.     ",
			"#####.# ##### #.#####",
			"    #.    #    .#    ",
			" ####.#########.#### ",
			" #........#........# ",
			" #.######.#.######.# ",
			" #o.#..... .....#.o# ",
			" ##.#.####.####.#.## ",
			" #.................# ",
			" #.#######.#######.# ",
			" #.................# ",
			" ################### "
		]
	},
	{
		"level": "Coop",
		"grid": [
			" ################### ",
			" #........#........# ",
			" #o##.###.#.###.##o# ",
			" #.................# ",
			" #.##.#.#####.#.##.# ",
			" #....#...#...#....# ",
			" ####.### # ###.#### ",
			"    #.#       #.#    ",
			"#####.# ##=## #.#####",
			"     .  #   #  .     ",
			"#####.# ##### #.#####",
			"    #.#       #.#    ",
			" ####.# ##### #.#### ",
			" #........#........# ",
			" #.##.###.#.###.##.# ",
			" #o.#..... .....#.o# ",
			" ##.#.#.#####.#.#.## ",
			" #....#...#...#....# ",
			" #.######.#.######.# ",
			" #.................# ",
			" ################### "
		]
	}
]